11111111111111111111111111111111111111111111111111
10000000000000000000000000000000000000000000000001
10100000000000000000000000000000000000000000000101
10100000000000000000000000000000000000000000000101
10100000000000000000000000000000000000000000000101
10100000000000000000000000000000000000000000000101
10100000000000000000000000000000000000000000000101
10100000000000000000000000000000000000000000000101
10100000000000000000000000000000000000000000000101
10100000000000000000000000000000000000000000000101
10100000000000000000000000000000000000000000000101
10100000000000000000000000000000000000000000000101
10100000000000000000000000000000000000000000000101
10100000000000000000000000000000000000000000000101
10100000000000000000000000000000000000000000000101
10100000000000000000000000000000000000000000000101
10100000000000000000000000000000000000000000000101
10100000000000000000000000000000000000000000000101
10100000000000000000000000000000000000000000000101
10100000000000000000000000000000000000000000000101
10100000000000000000000000000000000000000000000101
10100000000000000000000000000000000000000000000101
10110111011110111101111011011110111101111011101101
10000000000000000000000000000000000000000000000001
10000000000000000000000000000000000000000000000001
10110111011110111101111011011110111101111011101101
10100000000000000000000000000000000000000000000101
10100000000000000000000000000000000000000000000101
10100000000000000000000000000000000000000000000101
10100000000000000000000000000000000000000000000101
10100000000000000000000000000000000000000000000101
10100000000000000000000000000000000000000000000101
10100000000000000000000000000000000000000000000101
10100000000000000000000000000000000000000000000101
10100000000000000000000000000000000000000000000101
10100000000000000000000000000000000000000000000101
10100000000000000000000000000000000000000000000101
10100000000000000000000000000000000000000000000101
10100000000000000000000000000000000000000000000101
10100000000000000000000000000000000000000000000101
10100000000000000000000000000000000000000000000101
10100000000000000000000000000000000000000000000101
10100000000000000000000000000000000000000000000101
10100000000000000000000000000000000000000000000101
10100000000000000000000000000000000000000000000101
10100000000000000000000000000000000000000000000101
10100000000000000000000000000000000000000000000101
10100000000000000000000000000000000000000000000101
10000000000000000000000000000000000000000000000001
11111111111111111111111111111111111111111111111111
