11111111111111111111111111111111111111111111111111
10000000000000000000000000000000000000000000000001
10000000010000000000000000000000000000001000000001
10000000010000000000000000000000000000001000000001
10000000010000000000000000000000000000001000000001
10000000010000000000000000000000000000001000000001
10000000010000000000000000000000000000001000000001
10000000010000000000000000000000000000001000000001
10000000010000000000000000000000000000001000000001
10000000010000000000000000000000000000001000000001
10000000010000000000000000000000000000001000000001
10000000010000000000000000000000000000001000000001
10111111111111111000000000000000011111111111111101
10000000000000001000000000000000010000000000000001
10010000000000001000000000000000010000000000001001
10001000000000001000000000000000010000000000010001
10000100000000001000000000000000010000000000100001
10000010000000001000000000000000010000000001000001
10000001000000001000000000000000010000000010000001
10000000100000001000000000000000010000000100000001
10000000010000001000000000000000010000001000000001
10000000001000001000000000000000010000010000000001
10000000000000001000000000000000010000000000000001
10000000000000001000000000000000010000000000000001
10000000000000000000000000000000000000000000000001
10000000000000000000000000000000000000000000000001
10000000000000001000000000000000010000000000000001
10000000000000001000000000000000010000000000000001
10000000001000001000000000000000010000010000000001
10000000010000001000000000000000010000001000000001
10000000100000001000000000000000010000000100000001
10000001000000001000000000000000010000000010000001
10000010000000001000000000000000010000000001000001
10000100000000001000000000000000010000000000100001
10001000000000001000000000000000010000000000010001
10010000000000001000000000000000010000000000001001
10000000000000001000000000000000010000000000000001
10111111111111111000000000000000011111111111111101
10000000010000000000000000000000000000001000000001
10000000010000000000000000000000000000001000000001
10000000010000000000000000000000000000001000000001
10000000010000000000000000000000000000001000000001
10000000010000000000000000000000000000001000000001
10000000010000000000000000000000000000001000000001
10000000010000000000000000000000000000001000000001
10000000010000000000000000000000000000001000000001
10000000010000000000000000000000000000001000000001
10000000010000000000000000000000000000001000000001
10000000000000000000000000000000000000000000000001
11111111111111111111111111111111111111111111111111
