11111111111111111111111111111111111111111111111111
10000000000000000000100000000000000000000000000001
10000010000011110000100000000000000000000000000001
10000010000010000000100000000000000000000000000001
10000010000010000000100100000000000000000000000001
10001111111111111000100100000000000000000000000001
10000000000000001000111100000000000000000000000001
10000000000000001000000000000000000000000000000001
11111111111110000000000000000000000000000000000001
10000000000010000000011110000000000000000000000001
10000000000010001100010000000000000000000000000001
10000000100010001000010000000000000000000000000001
10001000100010001000010000000000000000000000000001
10001000100010001111111110000000000000000000000001
10001000111110001000000000000000000000000000000001
10001000000000001000000000000000000000000000000001
10001000000000001000000000000000000000000000000001
10001111111111111000100000000000000000000000000001
10001000000000100000100000000000000000000000000001
10001000000000100000100000000000000000000000000001
10000000110000111111100000000000000000000000000001
10000000100000100000000000000000000000000000000001
11111111100011100000000000000000000000000000000001
10000000100000000000000000000000000000000000000001
10000000100000000000000000000000000000000000000001
10001000100000000000000000000000000000000000000001
10001000100010000000000000000000000000000000000001
10001000100010000000000000000000000000000000000001
10001111111110000000000000000000000000000000000001
10000000000000000000000000000000000000000000000001
10000000000000000000000000000000000000000000000001
10000000000000000000000000000000000000000000000001
10000000000000000000000000000000000000000000000001
10000000000000000000000000000000000000000000000001
10000000000000000000000000000000000000000000000001
10000000000000000000000000000000000000000000000001
10000000000000000000000000000000000000000000000001
10000000000000000000000000000000000000000000000001
10000000000000000000000000000000000000000000000001
10000000000000000000000000000000000000000000000001
10000000000000000000000000000000000000000000000001
10000000000000000000000000000000000000000000000001
10000000000000000000000000000000000000000000000001
10000000000000000000000000000000000000000000000001
10000000000000000000000000000000000000000000000001
10000000000000000000000000000000000000000000000001
10000000000000000000000000000000000000000000000001
10000000000000000000000000000000000000000000000001
10000000000000000000000000000000000000000000000001
11111111111111111111111111111111111111111111111111
