11111111111111111111111111111111111111111111111111
10000000000000000000000000001000000000010000000001
10000010000011110000100000001000000000010000000001
10000010000010000000100000001000000000010000010001
10000010000010000000100100001100001000000000010001
10001111111111111000100100000000001000000000000001
10000000000000001000111100000000001000011110000001
10000000000000001000000000000000001000010010000001
10111111111110000000000000000000001000010010000001
10000000000010000000011111110000001111110010000001
10000000000010001100010000000000000000000010000001
10000000100010001000010000000000000000000011111101
10001000100010001000010000000100000000000000000001
10001000100010001111111100000100000010000000000001
10001000111110000000000000000111111110000000000001
10001000000000001000000001000000000000000001000001
10001000000000001000000001000000000000000001000001
10001111111111111000100001000000000000000001000001
10001000000000000000100001111111111111000001000001
10001000000000100000100000000000000001000001000001
10000000110000111111100000000000000001000001000001
10000000100000100000000001111000000001000000000001
10111111100011100000000000001000000001111000000001
10000000100000100000000000001000000000000000000001
10000000100000111110000000001111111000000000000001
10001000100000000000000111111000000000000111111101
10001000100010000000000000000000000000111100000001
10001000000010111110000000000000000000000100000001
10001111111110001000000000000000000000000100000001
10000000000000001000000111111111111100000000000001
10000000000000001111100000000000000100000000000001
11000000100000000000000000000000000100000000000001
10000000111110000000000111000000000100000111111111
10000000000010000010000001000000000100000000000001
11111100000010000010000001000000000100000000000001
10000000000010000010000001000000000100000000000001
10000000000010000010000001111011111100000010000001
10000111111111111111000000001000000100000010000001
10000000000000000000000000001000000000000010000001
10011110000000000000010000011110000000000010000001
10010000000000010000010000010000000011111110000001
10010000000000010000010000010000000000010000000001
10010000111111010000010000010000000000010000000001
10000000100000010000010000010010000000011100000001
10000000000000010000010000011110000000000000000001
10001000000011110000010000000000000000000000000001
11111000000010000000011000000000000001111110000001
10000000000010000000000000000000100000000010000001
10000000000000000000000000000000100000000010000001
11111111111111111111111111111111111111111111111111
