11111111111111111111111111111111111111111111111111
10000000000000000000100000001000000000000000000001
10100000000000000000000000000000000000000000000101
10010000000000000000100000001000000000000000001001
10001000000000000000000000000000000000000000010001
10000100000000000000100000001000000000000000100001
10000010000000000000000000000000000000000001000001
10000001000000000000101010101000000000000010000001
10000000100000000000000000000000000000000100000001
10000000000000000000000000000000000000000000000001
10000000000000000000000000000000000000000000000001
10000000000000000000000000000000000000000000000001
10000000000000000000000000000000000000000000000001
10000000000000000000000000000000000000000000000001
10000000000000000000000000000000000000000000000001
10000000000000000000000010000000000000000000000001
10000000000000000000000010000000000000000000000001
10000000000000001000000010000000100000000000000001
10000000000000000100000000000001000000000000000001
10000000000000000010001000100010000000000000000001
10000000000000000001001000100100000000000000000001
11010101000000000000101000101000000000000010101011
10000000000000000000001000100000000000000000000001
10000001000000000011111000111110000000000010000001
10000000000000000000000000000000000000000000000001
10000001000000111000000010000000111000000010000001
10000000000000000000000000000000000000000000000001
10000001000000000011111000111110000000000010000001
10000000000000000000001000100000000000000000000001
11010101000000000000101000101000000000000010101011
10000000000000000001001000100100000000000000000001
10000000000000000010001000100010000000000000000001
10000000000000000100000000000001000000000000000001
10000000000000001000000010000000100000000000000001
10000000000000000000000010000000000000000000000001
10000000000000000000000010000000000000000000000001
10000000000000000000000000000000000000000000000001
10000000000000000000000000000000000000000000000001
10000000000000000000000000000000000000000000000001
10000000000000000000000000000000000000000000000001
10000000000000000000000000000000000000000000000001
10000000100000000000000000000000000000000100000001
10000001000000000000101010101000000000000010000001
10000010000000000000000000000000000000000001000001
10000100000000000000100000001000000000000000100001
10001000000000000000000000000000000000000000010001
10010000000000000000100000001000000000000000001001
10100000000000000000000000000000000000000000000101
10000000000000000000100000001000000000000000000001
11111111111111111111111111111111111111111111111111
